20:0:0100
30:0:0010
40:0:1001
50:0:0110
60:0:2000
100:0:3000
